
sxswwwwwwws
sds.......s
s.s.s.s.s.s
s...s.sws.s
s...s.sts.s
s.swswwdw.s
s.sts.....s
s.wdw.swsws
s.....s.sts
s.www.w.wds
s.........s
wwwwwwwwwww